WALL x 121 y 1 z 85
WALL x 135 y 3 z 89
WALL x 131 y 1 z 87
WALL x 153 y 1 z 83
WALL x 133 y 1 z 89
WALL x 137 y 1 z 83
WALL x 147 y 1 z 91
WALL x 131 y 1 z 77
WALL x 129 y 1 z 83
WALL x 119 y 1 z 75
WALL x 135 y 1 z 75
WALL x 139 y 1 z 89
WALL x 141 y 1 z 85
WALL x 139 y 1 z 85
WALL x 129 y 1 z 93
WALL x 133 y 1 z 77
WALL x 125 y 1 z 77
WALL x 135 y 1 z 87
WALL x 141 y 1 z 83
WALL x 141 y 1 z 75
WALL x 129 y 1 z 87
WALL x 137 y 3 z 83
WALL x 123 y 1 z 75
WALL x 133 y 5 z 89
WALL x 127 y 1 z 85
WALL x 151 y 1 z 79
WALL x 149 y 1 z 79
WALL x 125 y 1 z 83
WALL x 121 y 1 z 87
WALL x 147 y 1 z 77
WALL x 133 y 3 z 87
WALL x 149 y 1 z 85
WALL x 155 y 1 z 87
WALL x 153 y 1 z 81
WALL x 139 y 1 z 73
WALL x 167 y 1 z 105
WALL x 123 y 1 z 91
WALL x 137 y 1 z 79
WALL x 137 y 1 z 81
WALL x 131 y 1 z 79
WALL x 139 y 1 z 87
WALL x 141 y 1 z 87
WALL x 129 y 1 z 85
WALL x 145 y 1 z 85
WALL x 143 y 1 z 89
WALL x 127 y 1 z 77
WALL x 137 y 3 z 81
WALL x 129 y 1 z 89
WALL x 135 y 1 z 89
WALL x 141 y 1 z 77
WALL x 151 y 1 z 91
WALL x 135 y 1 z 91
WALL x 173 y 1 z 103
WALL x 127 y 1 z 87
WALL x 133 y 1 z 87
WALL x 133 y 5 z 87
WALL x 121 y 1 z 75
WALL x 131 y 1 z 81
WALL x 123 y 1 z 83
WALL x 133 y 3 z 89
