SANDSTONE x 99 y 1 z 123
SAND x 109 y 1 z 123
SANDSTONE x 101 y 1 z 123
SAND x 107 y 1 z 123
SAND x 111 y 1 z 123
SAND x 105 y 1 z 123
SAND x 103 y 1 z 123
